...........................
.    .     .       .     ..
. . . ... . ..... . ... ...
. . .   . .     . .   .   .
. . ... . ..... . ... ... .
. .     .     . .     .   .
. ..... ..... . . ..... ...
.     .  S  . . .     .   .
..... . ... . . ... ..... .
.     . .   . .   .     . .
. ..... . ... . . ... . . .
.       .     . .     . . .
. ........... . ....... . .
.E                .       .
...........................
